Bob	simplepass
Alice	BetT3RpAas
Karen	iDontHaveALastName
Guy	mySecureP@ss123
David	network2025
Sarah	tcpRocks!
Mike	s3l3ctIsC00l
Emma	pythonLover99
John	serverAdmin
Lisa	clientSide456
Tom	caesarCipher3
Rachel	lcmIsFun
Kevin	parentheses()
Nina	socket$erver
Chris	select123
Maya	authentication
Ryan	multiClient
Sophia	ioMultiplexing
Daniel	computerNetworks
Olivia	TAU_student